041604160041111-
121212121121111-
121212121121111-
121212121121111-
121212121121111-
121212121121111-
130513051130111-
111111111111111